GGC	G
GCG	A
CCG	P
ACC	T
CCA	P
CAG	Q
UAU	Y
UCC	S
CCC	P
GCC	A
UCA	S
AGC	S
CGU	R
CGA	R
UAG	*
AGG	R
AAG	K
UUU	F
UUA	L
GUA	V
AUG	M
UGC	C
CGG	R
GUC	V
CUC	L
CAA	Q
GGG	G
GAA	E
GUG	V
UGA	*
AAU	N
ACG	T
AGA	R
AAA	K
CUG	L
CUU	L
AUC	I
AUU	I
GAU	D
ACU	T
GCU	A
CAC	H
UUG	L
AAC	N
AGU	S
UAC	Y
GAG	E
GUU	V
UGU	C
UUC	F
CUA	L
CAU	H
UCU	S
CGC	R
CCU	P
GGA	G
UAA	*
GAC	D
GGU	G
GCA	A
UGG	W
ACA	T
UCG	S
AUA	I
